111111
1E0111
1C0111
1CP111
111111